1111111111
1000000001
1001110001
10010100C1
1001110001
1000000001
100P000001
1000000011
1000000E01
1111111111
